# Nokia_5110 class
Nokia_5110	KEYWORD1

setContrast	KEYWORD2
setTemperatureCoefficient	KEYWORD2
print	KEYWORD2
println	KEYWORD2
clear	KEYWORD2
setCursor	KEYWORD2
setDisplayMode	KEYWORD2
setBiasSystem	KEYWORD2



# Cursor class
Cursor	KEYWORD1

setCursor	KEYWORD2
moveXAxis	KEYWORD2
moveYAxis	KEYWORD2
getPosition	KEYWORD2



# Mux_Rate class
Mux_Rate	KEYWORD1

HUNDRED	LITERAL1
EIGHTY	LITERAL1
SIXTY_FIVE	LITERAL1
FORTY_EIGHT	LITERAL1
FORTY	LITERAL1
TWENTY_FOUR	LITERAL1
EIGHTEEN	LITERAL1
TEN	LITERAL1


# Display_Mode class
Display_Mode	KEYWORD1

BLANK	LITERAL1
NORMAL	LITERAL1
ALL_SEGMENTS_ON	LITERAL1
INVERSE_VIDEO	LITERAL1
